  ______                 _           _____                       
 |  ____|               | |         |  __ \                      
 | |__   _ __ ___  _ __ | |_ _   _  | |__) |___   ___  _ __ ___  
 |  __| | '_ ` _ \| '_ \| __| | | | |  _  // _ \ / _ \| '_ ` _ \ 
 | |____| | | | | | |_) | |_| |_| | | | \ \ (_) | (_) | | | | | |
 |______|_| |_| |_| .__/ \__|\__, | |_|  \_\___/ \___/|_| |_| |_|
                  | |         __/ |                              
                  |_|        |___/                               


          [1] Prey (Restore Health)       [2] Go Forward
 __________________________________________________________________

