  __  __                 _              _____                       
 |  \/  |               | |            |  __ \                      
 | \  / | ___  _ __  ___| |_ ___ _ __  | |__) |___   ___  _ __ ___  
 | |\/| |/ _ \| '_ \/ __| __/ _ \ '__| |  _  // _ \ / _ \| '_ ` _ \ 
 | |  | | (_) | | | \__ \ ||  __/ |    | | \ \ (_) | (_) | | | | | |
 |_|  |_|\___/|_| |_|___/\__\___|_|    |_|  \_\___/ \___/|_| |_| |_|
                                                                    
                                                                    
